#### ############B#
#### ############ #
####              #
########### #######
########### #######
###         #######
### ###############
### ############ ## 
### ############ ##
###            # ##
####### ######## ##
####### #####     
#       #####  ####
# ########### #####
# ##########  #####
# ########## ######
# ########## ######
# # ######## ######
# #               #
#A#################

